weiboId	int
attitudes_count	int
bmiddle_pic	varchar
comments_count	int
created_at	varchar
favorited	bit
geo	varchar
id	bigint
idstr	varchar
in_reply_to_screen_name	varchar
in_reply_to_status_id	varchar
in_reply_to_user_id	varchar
mid	varchar
mlevel	int
original_pic	varchar
pic_urls	varchar
reposts_count	int
source	varchar
text	varchar
thumbnail_pic	varchar
truncated	bit
uid	bigint
visible	varchar
retweeted_status_id	bigint
gatherTime	bigint